EEEEEEEEEEEEEEEEEEEEEEEEEEEEEE
EEEEEEEEEEEEEEEEEEEEEEEEEEEEEE
EEEEEEEEEGEEEEESEEEERRRRRRRRRR
RORRREEEEGEEEEESEEEEREEEEEEEEE
EEEEREEEEGEEEEESEEEEREEEEEEEEE
EEEEREEEEGEEEEESEEEEREEEEEEEEE
EEEEREEEEGEEEEESEEEEREEEEEEEEE
EEEEREEEEEEEEEEEEEEEREEEEEEEEE
EEEEREEEEEEEEEEEEEEEREEEEEEEEE
EEEEREEEEEEEEEEEEEEEREEEEEEEEE
EEEEREEEEEEEEBEEEEEEREEEEEEEEE
EEEEREEEEEEEEEEEEEEEREEEEEEEEE
EEEEREEEEEEEEEEEEEEEREEEEEEEEE
EEEEREEEEEEEEEEEEEEEREEEEEEEEE
EEEEREEEEEEEEEEEEEEEREEEEEEEEE
EEEERRRRRRRRRRRRRRRRREEEEEEEEE
EEEEEEEEEEEMEEEEEEEEEEEEEEEEEE
EEEEEEEEEEEEEEEEEEEEEEEEEEEEEE