EEEEEEEEEEEEEEEEEEEEEEEEEEEEEE
EEEEEEEEEEEEEEEEEEEEEEEEEEEEEE
EEEEEEEEEGEEEEEGEEEERRRRRRRRRR
RORRREEEEGEEEEEGEEEEREEEEEEEEE
EEEEREEEEGEEEEEGEEEEREEEEEEEEE
EEEEREEEEGEEEEEGEEEEREEEEEEEEE
EEEEREEEEGEEEEEGEEEEREEEEEEEEE
EEEEREEEEEEEEEEEEEEEREEEEEEEEE
EEEEREEEBEEEEEEEEEEEREEEGEEEEE
EEEEREEEEEEEEEEEEEEEREEEGEEEEE
EEEEREEEEEEEEEEEEEEEREEEGEEEEE
EEEEREEEBEEEEEEEEEEEREEEGEEEEE
EEEEREEEEEEEEEEEEEEEREEEGEEEEE
EEEEREEBEEEEEEEEEEEEREEEGEEEEE
EEEEREEEEEEEEEEEEEEEREEEGEEEEE
EEEERRRRRRRRRRRRRRRRREEEEEEEEE
EEEEEEEEEEEMEEEEEEEEEEEEEEEEEE
EEEEEEEEEEEEEEEEEEEEEEEEEEEEEE