EEEEEEEEEEEEEEEEEEEEEEEEEEEEEE
EEEEEEEEEEEEEEEEEEEEEEEEEEEEEE
EEEEEEEEEGEEEGEEEEEERRRRRRRRRR
RORRREEEEEEEEEEEEEEEREEEEEEEEE
EEEEREEEEGEEEGEEEEEEREEEEEEEEE
EEEEREEEEEEEEEEEEEEEREEEEEEEEE
EEEBREEEEEEEEEEEGEEEREEEEEEEEE
EEEEREEEEEEEEEEEEEEEREEEEEEEEE
EEEEREEEEEEEEEEEEEEEREEEEEEEEE
EEEEREEEEEEEEEEEEEEEREEEEEEGEE
EEBEREEEEEEEEEEEEEEEREEEEEEEEE
EEEEREEEEEEEEEGEEEEEREEEEEEEEE
EEEEREEEGEEEEEEEEEEEREEEEEEEEE
EEEEREEEEEEEEEEEEEEEREEEEEEEEE
EEEEREEEEEEEEEGEEEEEREEEEEEEEE
EEEERRRRRRRRRRRRRRRRREEEEEEEEE
EEEEEEEEEEEMEEEEEEEEEEEEEEEEEE
EEEEEEEEEEEEEEEEEEEEEEEEEEEEEE